11111111111111111111111111111111111111111111111111111
11111111111111111111111111111111111111111111111111111
11000100000001000222220000000100000000010000000100011
11010111011101111111111101110101111111011101111100011
11010001010100000000000101010001000001000001000100011
11011101010111222111110101011111011111111111110111011
11010100010000000000010101022001000000010000000101011
11010111110111011111110101010111011101110111010101011
11010000000001010000000101010000010001000101010001011
11010111111101110111111101111101110111011101011101011
11010100000100010001000001000100010000000001010101011
11011101110111011101110111010111011111111111010101011
11010001000000010100010000010100010100000001010001011
11010111111211010111011101110111010101111101010111011
11010000210001010001000100010001000101000001010100011
11010102210111011101110111111101110101110111010101111
11010122010000200100010100222001000100010000010101011
11010120011111110101010101121111011111011111110101011
11010120000001000101010001000001000101000000022100011
11011111111101011101111111011111110101111101022111011
11012000000101000001000001000000010001000101022001011
11010111110101111111010111011111011101010111211111011
11222100000100000000010022212201000001010001222222011
11011101111111111111111111112101111111011101200002011
11000100000000000000000222222122000000000100002200011
11111111111111111111111111111111111111111111111111111
11111111111111111111111111111111111111111111111111111

